4 69 1223 7671 5091 5199 5508 185 7495 4704 7424 4887 7304 2742 7233 7168 77 7142 7075 2440 4975 2006 6965 6975 4913 6907 6884 5287 6827 2494 6817 6770 4397 6687 6660 4096 902 2289 5412 5109 1227 885 6499 3338 6441 6415 6402 2114 6356 2513 6320 3910 228 2886 520 3272 4258 5399 4756 1298 4222 6139 4080 2402 6119 6114 2998 6100 265 6069 13256 
4 52 1223 7707 7725 2259 765 7676 4784 7625 7649 7575 7623 7606 2706 7605 4336 7695 7720 7750 4365 7810 3695 7816 302 7848 7815 7847 7791 7756 5654 7762 1181 7733 7730 4050 7712 7711 4202 4318 7748 2517 2175 7697 2101 7614 7587 4677 3312 7586 7624 7603 1146 7522 
4 49 1223 7764 4308 915 7858 7889 7868 1034 7857 1164 987 1992 7873 7872 4851 3769 7888 4749 3251 5711 3695 587 7942 1484 2447 4708 4283 2943 8045 3773 8032 2954 3491 8179 2526 8243 8290 2587 8261 2752 8354 5104 4191 887 1861 8590 3849 8463 1861 
4 23 8179 3299 5261 648 8062 238 2765 7967 3008 8003 1874 4217 2438 5406 2502 1051 7742 1064 7700 5348 7602 1146 7522 
3 10 9 1417 6851 5256 4338 6900 4884 816 3079 3732 
3 17 9 6782 3694 3063 6741 2068 6690 391 6633 4497 6630 2488 6628 4127 6644 6643 6660 
3 15 9 2791 4794 1103 7020 162 7105 7086 337 7123 7168 77 7195 7232 4626 
1 24 1005 5019 4701 5317 5505 7098 7118 7135 7191 1750 7219 3080 4984 7150 2678 5610 7223 4626 5030 7308 4716 7410 4704 7424 
1 32 7179 7140 3072 7225 7276 4705 4973 7258 3826 7333 7326 945 5079 7316 4614 7380 7428 1939 7460 3126 7489 7533 5540 4206 3690 549 5190 7653 7615 3875 691 7671 
1 21 7610 7630 2899 3271 5659 2575 5702 894 7783 7776 7807 3657 3365 7841 3367 4722 250 5495 7811 7786 7764 
3 27 1005 4989 7229 7290 3674 2358 2011 2520 5637 2824 2536 7447 3089 7394 4883 7360 3387 5695 3989 2019 2241 7500 7492 3923 4907 7522 1146 
2 10 2835 2363 5428 6845 4861 4276 2571 6911 2351 5287 
1 7 2835 6676 5270 1464 6768 1470 6770 
1 6 1005 7004 1766 6865 1415 3425 
3 24 1830 5444 8018 7999 7982 8012 4427 7996 7998 7978 4026 7989 5280 7988 7977 7947 7995 5407 7994 7949 1918 3686 7840 4308 
1 11 7003 7047 4303 4700 7134 1653 1771 7339 294 7425 7492 
1 12 7544 2883 5643 5304 7445 7462 7498 32 7397 7432 3015 7522 
1 8 6808 2448 2744 6855 6874 6898 6883 6837 
1 5 6849 6857 6880 3618 6830 
3 10 3910 2838 2361 5272 2740 1393 3037 6390 2413 6449 
2 11 6251 6239 6222 4755 322 6238 2378 3627 6249 4643 5219 
1 10 6213 857 3146 1704 991 4897 2374 1948 1067 6251 
1 10 2539 3042 737 6333 1538 4444 6288 1772 4466 6222 
1 6 3547 6503 5536 6474 6464 6449 
2 13 13249 6057 4153 6085 1969 5046 270 6144 3300 6181 258 4316 6239 
2 18 13267 6090 6095 6109 6116 6126 2096 2107 1837 2723 6179 2856 6195 186 6231 6257 4048 3910 
1 14 6204 331 5550 4323 6221 6237 2826 1374 6274 421 6250 5132 6280 4048 
3 16 3269 963 6396 6371 5489 6337 3692 6313 2851 4635 1381 5157 6315 6301 2389 3910 
1 2 1564 3269 
1 2 4733 3269 
1 2 1564 3269 
1 2 3269 1564 
2 21 6311 4492 2825 6322 6348 4846 6360 6349 3035 3546 1217 6355 4763 5042 6319 6297 1818 1254 6235 2018 6204 
1 9 1217 6376 1925 1842 3201 6414 6431 6444 4733 
1 8 4986 3085 6597 5197 3873 6678 6731 6782 
1 7 5276 6750 1133 447 6792 573 5256 
2 29 8149 8146 8161 8196 5379 5114 8148 8126 8160 3065 233 8237 404 1196 8150 8135 237 8134 8137 2595 8093 8086 4360 5383 4340 4344 8074 5444 1830 
4 52 8887 3932 4273 5709 172 8907 8886 5139 4905 8841 2836 5177 8824 8803 8823 5582 2216 153 8903 8895 5390 8837 2908 668 8798 4436 8751 8701 8642 4226 4870 8591 8536 8483 8473 4366 8399 8376 5161 8335 5233 8244 13268 13269 13270 13271 13272 2256 8056 8059 8019 7994 
2 19 8244 8275 8276 8270 8277 144 3604 4665 8250 8212 4715 8232 8218 8245 8210 8188 4434 5468 2595 
2 32 2943 8037 8079 5482 2497 8141 3626 8274 8330 3238 8455 832 5080 8579 8606 8595 531 8693 8716 1554 5062 3297 8877 5050 8854 8858 5060 4060 8873 4740 8850 2908 
1 27 8590 1945 3707 5273 8764 8795 2807 5552 4021 4494 8891 8847 4824 8796 8730 4359 2882 2905 8549 402 8529 8535 3455 3333 3320 8503 832 
1 5 8820 4297 5165 2720 5080 
1 17 8274 8282 1630 4598 8190 8203 8166 3150 4045 2242 4314 8058 1140 8065 5618 4670 2256 
2 20 6545 6548 1963 6549 1083 2602 6533 6537 4148 864 80 6536 2027 2293 6531 2281 4024 5146 6520 885 
2 13 2706 1359 1888 7507 7506 2319 7422 672 7303 7230 2362 4833 1005 
